11111111111111111111
1E000C0CC000CC00C011
10C01C1100C0C000C111
10C0CC010C0C01CCC011
10C0CC010C0C01CCC011
10C01C1100C0C000C111
10C0CC010C0C01CCC011
100P0C0C0CC00C00C011
10C0CC010C0C01CCC011
11111111111111111111