111111111
1E001C101
10X00C111
100P1C0C1
111111111