1111111111111111111
1E000C0CC000CC00C01
10C01C1100C0C000C11
10C01C1100C0C000C11
10C01C1100C0C000C11
100P0C0C0CC00C00C01
1111111111111111111