NO ./path_to_the_north_texture
SO ./path_to_the_south_texture
WE ./path_to_the_west_texture
EA ./path_to_the_east_texture

  F 2 20,3   0,    0

C 22 5,13   0,   0





    1111111111111111111111111
        100000000011000000000000111111111
        1011000001110000000000001
        1001000000000000000000001
111111111011000001110000000000001
100000000011000001110111111111111
11110111111111011100000010001
11110111111111011101010010001
110000000010101011100000010001
1000000N0000000001100000010001
11111111011000001110000000000001
100000000011000001110111111111111
11110111111111011100000010001
11110111111111011101010010001
11000000001010101110000001000111111111
100000000011000001110111111111111
11110111111111011100000010001
11110111111111011101010010001
11000000001010101110000001000111111111011000
100000000011000001110111111111111
11110111111111011100000010001
11110111111111011101010010001
110000000010101011100000010001111111110110000
100000000011000001110111111111111
11110111111111011100000010001
11110111111111011101010010001
11000000001010101110000001000111111111011000001
100000000011000001110111111111111
11110111111111011100000010001
11110111111111011101010010001
110000000010101011100000010001100000000000000
1100000111010101111101111010111
11110111 1110101 101111010001
11111111 1111111 111111111111