   NO textures/photo_butterfly.png
SO textures/photo_lake.png
WE textures/photo_clouds.png
EA textures/photo_cabin.png

C 100, 170, 255

F 70, 45,  45




    11111111111111111111111111111
        1000000000110000000000001
        1011000001110000000000001
        1001000000000000000000001
111111111011000001110000000000001
100000000011000001110111111111111
11110111111111011100000010001
111101111111101110101001000111
110000000010101011100000010001
1000000N0000000001100000010001
100000000000000011010100100011
1100000111010101111101111010111
11110111 1110101 101111010001
11111111 1111111 111111111111