NO ./img/north.xpm42
SO ./img/south.xpm42
WE ./img/west.xpm42
EA ./img/east.xpm42

F 0, 50, 100
C 50,10,0

        1111111111111111111111111
        1000000100000000000000001
        1011010100000000000000001
        1001010100000000000000001
111111111011010111100000000000001
100000000011010001110111111111111
11110111111111011100000010001
11110111111111011101010010001
1100E001110101011100000010001
10000000000000000000000000001
10000000000000000000000000001
10000000000000000000000000001
10000000100000001100000010001
10000001000000001101010010001
1100000111010101111101111000111
11110111 1110101 101111010001
11111111 1111111 111111111111