   NO textures/bars.png
SO textures/photo_lake.png
WE textures/photo_clouds.png
EA textures/photo_cabin.png

C 100, 170, 255

F 70, 45,  45


111111111
100000001
100010001
100S00101
100010001
100000001
111111111