   NO textures/north.png
SO textures/south.png
WE textures/west.png
EA textures/east.png

F 95, 75,     75

C 22 5,13   0,   0









   111111111         
 111101111
110000N1    
11111011
11111111111

