NO ./path_to_the_north_texture
SO ./path_to_the_south_texture
EA ./path_to_the_east_texture
WE ./path_to_the_west_texture




  F 2 20,3   0,    0
C 22 5,13   0,   0







   111111111    
1111000011
110010111
111000N1111111
111111111



