   NO textures/north.png
SO textures/south.png
WE textures/west.png
EA textures/east.png

F 95, 75,     75

C 22 5,13   0,   0



1111111111111111
1000000000000001
1000000000000001
1000000000000001
1000000E00000001
1000000000111111
1000000000000001
1000000000000001
1111111111111111