   NO textures/north.png
SO textures/south.png
WE textures/west.png
EA textures/east.png

F 95, 75,     75

C 22 5,13   0,   0





11111
10001
10S01  
10001
10001
10001
10001
10001
10001
10001
10001
11111
