   NO textures/photo_butterfly.png
SO textures/photo_lake.png
WE textures/photo_clouds.png
EA textures/photo_cabin.png

C 100, 170, 255

F 70, 45,  45

1111111
1000101
10001011
100S0001
10001011
10001011
1111111