NO ./path_to_the_north_texture
SO ./path_to_the_south_texture
WE ./path_to_the_west_texture
EA ./path_to_the_east_texture

  F 2 20,3   0,    0

C 22 5,13   0,   0






        
111111
10S001
111011
11111 