   NO textures/north.png
SO textures/south.png
WE textures/west.png
EA textures/east.png

F 95, 75,     75

C 22 5,13   0,   0






1111111111111
   111111111         
 111101111
110N011     
11111011
11111111111

  
