   NO textures/north.png
SO textures/south.png
WE textures/west.png
EA textures/east.png

F 95, 75,     75

C 22 5,13   0,   0





      11111
      10101
      1000111
      10000011111
   11110000000011111
   100000E0000000001
   11110000011111001
      1000111   1111
      10001
      10001
      10001
      10001
      11111
