   NO textures/north.png
SO textures/south.png
WE textures/west.png
EA textures/east.png

F 95, 75,     75

C 22 5,13   0,   0





      11111
      10001
      10101
      100011111
   111100011001111
   10000N000000001
   111100011111111
      10001
      10001
      10001
      10001
      10001
      11111
