   NO textures/photo_butterfly.png
SO textures/photo_lake.png
WE textures/photo_clouds.png
EA textures/photo_cabin.png

C 100, 170, 255

F 70, 45,  45

111111111111111111111111111
100000000000000000000000001
1000N0001110000001111100001
100000110110000010001100001
100001100110000000011000001
100011111111100000110000001
100000000110000011000000001
100000000110000111111000001
100000000000000000000W00001
111111111111111111111111111