NO ./img/north.xpm42
SO ./img/south.xpm42
WE ./img/west.xpm42
EA ./img/east.xpm42

F 220,100,0
C 225,30,0

111111111111111111111111111
100000000000000000000000001
1000N0001110000001111100001
100000110110000010001100001
100001100110000000011000001
100011111111100000110000K01
100000000110000011000000001
100000000110000111111000001
100000000000000000000W00001
111111111111111111111111111